|===========|       
|   |     | |       
|   | | | | |       
| |=| | | | |       
| |   | |   |       
| | | |=====|       
| | |       |       
| | |=====| |       
| |     | | |       
| |===| | | |       
|   |   | | |       
|=| | |=| | |       
|M    |C    |       
|===========|       
                    
                    
                    
                    
                    
                    
